#######
#     #############
#  X     P        #
#  O        #  X  #
#         O #     #
#                 ##############
#                              #
#                              #
#                              #
################################
